1111111111111111111111111111111111111111111111111111111111111111111111
1000000000010000000000000000000000000000000000000000000000000000000001
1000000000010000000000000000000000000000000000000000000000000000000001
1000000000010000000000000000000000000000000000100000000000000000000001
1000000000010000001111111111100000000000000000100000000000000000000001
1000000000010000000000000000000000000000000000000000000000000000000001
1000000000010000000000000000000000000000000000100000000000000000000001
1000000000010000000000000000000000000000000000000000000000000000000001
1000000000010000000000000000000000000000000000000000000000000000000001
1000000000010000000000000000000000000000000000000000000000000000000001
1000000000010000000000000001111000000000000000000000000000000000000001
1000000000011111111100000000000000000000000000000000000000000000000001
1000000000000000000100000000000000000000000000000000000000000000000001
1000000000000000000100000000000000000000111111111111111111111111111111
1000000000000000000100000011111110000000000000000000000000000000000001
1000000000000111111100000000000000000000000000000000000000000000000001
1000000000000000001100000000000011110000000000000111111100100000000001
1000000000000000001100000000000000000000000000000000000000000000000001
10000000000000000000000000000000000000000000000000000000000000000000$1
1111111111111111111111111111111111111111111111111111111111111111111111